11 15
---------------
|           xG|
|           xx|
|             |
|             |
|             |
|  xxxxxxxxx  |
|          x  |
|   S      x  |
|          x  |
---------------