14 17

-----------------

|               |

|               |

|            G  |

|               |

|               |

|               |

|               |

|  xxxxxxxxx    |

|          x    |

|   S      x    |

|          x    |

|               |

-----------------
